7 15 20
###############
# @  *---   *+#
######   ######
#%       H    #
#       #H#####
#+*  * * H    #
###############
