7 15 40
###############
# @  *     + +#
######   ######
#   ---- H    #
####  % #H#####
#    *%* H *  #
###############
