7 15 30
###############
# @  *---  +* #
######   ######
#        H  % #
##H#    #H#####
# H% * * H    #
###############
